#################################################################################
#                                                                               #
#                                                                               #
#                                                                               #
#                                                                               #
#                                                                               #
#                                                                               #
#                                                                               #
#                                                                               #
#                                                                               #
#                                                                               #
#                                                                               #
#                                                                               #
#                                                                               #
#                                                                               #
#                                                                               #
#                                                                               #
#                                                                               #
#                                                                               #
#                                                                               #
#                                                                               #
#                                                                               #
#                                                                               #
#                                                                               #
#                                                                               #
#                                                                               #
#                                                                               #
#                                                                               #
#################################################################################