#################################################################################
#                                      ####                                     #
#                                    ##    ##                                   #
#                    ######       ##         ##       ######                    #
#                          #    ##             ##    #                          #
#                           ####                 ####                           #
#              #            ##                     ##            #              #
#               #         ##                         ##         #               #
#                #########      ##             ##      #########                #
#                     ##        ##             ##        ##                     #
#                   ##                                     ##                   #
#                 ##                                         ##                 #
#     ############                      ##                     ############     #
#                                      ####                                     #
#                                                                               #
#                                      ####                                     #
#     ############                      ##                     ############     #
#                 ##                                         ##                 #
#                   ##                                     ##                   #
#                     ##        ##             ##        ##                     #
#                #########      ##             ##      #########                #
#               #         ##                         ##         #               #
#              #            ##                     ##            #              #
#                           ####                 ####                           #
#                          #    ##             ##    #                          #
#                    ######       ##         ##       ######                    #
#                                    ##    ##                                   #
#                                      ####                                     #
#################################################################################