##########################                             ##########################
#                                                                               #
#                                                                               #
#                                                                               #
#                                                                               #
#                                                                               #
#                                                                               #
#                                                                               #
#                                                                               #
#                                                                               #
                  ##############################################                 
                                                                                 
                                                                                 
                                                                                 
                                                                                 
                                                                                 
                                                                                 
                                                                                 
                  ##############################################                 
#                                                                               #
#                                                                               #
#                                                                               #
#                                                                               #
#                                                                               #
#                                                                               #
#                                                                               #
#                                                                               #
#                                                                               #
##########################                             ##########################