#################################################################################
#                                                                               #
#                                                                               #
#                                                                               #
#        ###############        #                        ###############        #
#               #               #                               #               #
#               #               #                               #               #
#               #               #                               #               #
#               #               #                               #               #
#               #               #                               #               #
#               #               #                               #               #
#               #               ################                #               #
#                                                                               #
#                                                                               #
#                                                                               #
#                                                                               #
#                                                                               #
#               #               ################                #               #
#               #               #                               #               #
#               #               #                               #               #
#               #               #                               #               #
#               #               #                               #               #
#               #               #                               #               #
#               #               #                               #               #
#        ###############        #                        ###############        #
#                                                                               #
#                                                                               #
#                                                                               #
#################################################################################