                  ##############################################                 
                                                                                 
                                                                                 
                                                                                 
       #############                                          #############      
       #                                                                  #      
       #                                                                  #      
#      #                 #####                     #####                  #     #
#      #                 #                             #                  #     #
#                        #                             #                        #
#                        #                             #                        #
#            #############                             #############            #
#                                                                               #
#                                                                               #
#                                                                               #
#                                                                               #
#                                                                               #
#            #############                             #############            #
#                        #                             #                        #
#                        #                             #                        #
#      #                 #                             #                  #     #
#      #                 #####                     #####                  #     #
       #                                                                  #      
       #                                                                  #      
       #############                                          #############      
                                                                                 
                                                                                 
                                                                                 
                  ##############################################                 