########      ########            #############            ########      ########
#                    #                                     #                    #
#                    #       #                     #       #                    #
                             #                     #                             
                             #                     #                             
#                    #       #                     #       #                    #
#                    #                                     #                    #
########      ########            #############            ########      ########
                                                                                 
                                                                                 
                                     ######                                      
                                     ######                                      
           ######                                               ######           
           ######                                               ######           
                                                                                 
                                                                                 
                            ######            ######                             
                            ######            ######                             
                                                                                 
                                                                                 
                                                                                 
########      ########            #############            ########      ########
#                    #                                     #                    #
#                    #       #                     #       #                    #
                             #                     #                             
                             #                     #                             
#                    #       #                     #       #                    #
#                    #                                     #                    #
########      ########            #############            ########      ########