################################                 ################################
#                              #                 #                              #
#                              #                 #                              #
#            #   #             ####           ####        ##############        #
#          ###   ###           #                 #                              #
#                              #                 #                              #
#          ###   ###           #                 #        ##############        #
#            #   #             #######     #######                              #
#                                                                               #
#                                                                               #
#############################                       #############################
                            #      ###     ###      #                            
                            #      #         #      #                            
                                                                                 
                                                                                 
                                                                                 
                            #      #         #      #                            
                            #      ###     ###      #                            
#############################                       #############################
#                                                                               #
#                                                                               #
#    ###              ###      #######     #######               ##             #
#       ###        ###         #                 #               ##             #
#            ####              #                 #         ##############       #
#       ###        ###         #                 #               ##             #
#    ###              ###      ####           ####               ##             #
#                              #                 #                              #
#                              #                 #                              #
################################                 ################################