#################################################################################
#                                                                               #
#                                                                               #
#                                                                               #
#           ##   ##                                           ###               #
#           #     #                                           ###               #
#       #####     #####                                                         #
#       #             #                               ###             ###       #
#       #             #                               ###             ###       #
#       #####     #####                                                         #
#           #     #                                           ###               #
#           ##   ##                                           ###               #
#                                                                               #
#                               #################                               #
#                                                                               #
#                                                                               #
#                       #################################                       #
#                       #################################                       #
#                       #################################                       #
#       #########       #################################       #########       #
#       #########       #################################       #########       #
#       #########       #################################       #########       #
#       #########       #################################       #########       #
#                       #################################                       #
#                       #################################                       #
#                       #################################                       #
#                       #################################                       #
#                       #################################                       #
#################################################################################