#################################################################################
#                                                                               #
#                                                                               #
#                                                                               #
#          ####################                   ########    ########          #
#          #                  #                   #                  #          #
#          #                  #                   #                  #          #
#                  ####                           #       ####       #          #
#                  ####                           #       ####       #          #
#          #                  #                   #                  #          #
#          #                  #                   #                  #          #
#          ####################                   ########    ########          #
#                                  #         #                                  #
#                                  #         #                                  #
#                                  #         #                                  #
#                                  #         #                                  #
#                                  #         #                                  #
#                                  #         #                                  #
#                                                                               #
#                                                                               #
#                  ###########################################                  #
#                  #   ###   ###   ###     ###   ###   ###   #                  #
#                                                                               #
#                                                                               #
#                  #      ###   ###   #####   ###   ###      #                  #
#                  ###########################################                  #
#                                                                               #
#                                                                               #
#################################################################################