#################################################################################
#                                                                               #
##                                                                             ##
###           #####################################################           ###
####            ##                                             ##            ####
#####             ##                                         ##             #####
######              ##                  #                  ##              ######
#######               ##              #####              ##               #######
########                ##              #              ##                ########
#########                 ##                         ##                 #########
##########                  ##                     ##                  ##########
###########                   #######       #######                   ###########
############                                                         ############
#############                                                       #############
##############                                                     ##############
#############                                                       #############
############                                                         ############
###########                   #######       #######                   ###########
##########                  ##                     ##                  ##########
#########                 ##                         ##                 #########
########                ##            #####            ##                ########
#######               ##                                 ##               #######
######              ##                #####                ##              ######
#####             ##                                         ##             #####
####            ##                                             ##            ####
###           #####################################################           ###
##                                                                             ##
#                                                                               #
#################################################################################